1 1 1 1 1 1 1 1 1 1 1 1 1 1 1 1 1 1 1 1 1 1 1 1 1 1 1 1 1 1 1 1 1 1 1 1 1 1 1 1 1 1 4 1 1 1 1 1 1 1 
1 1 1 1 1 1 1 1 4 1 1 1 1 1 1 1 1 1 1 1 1 1 1 4 1 1 1 1 1 1 4 1 1 1 1 1 1 1 1 1 1 1 1 1 1 1 1 1 1 1 
1 4 1 1 1 1 1 1 1 1 1 1 1 1 1 1 1 1 1 1 1 1 1 1 1 1 1 1 1 1 1 1 1 1 1 1 1 1 1 1 1 1 1 1 1 1 1 1 1 1 
1 1 1 1 1 1 1 1 1 1 1 1 1 1 1 4 1 1 1 1 1 1 1 1 1 1 1 1 1 1 1 1 1 1 1 1 1 1 1 4 1 1 1 1 1 1 1 4 1 1 
4 1 1 1 1 1 1 1 1 1 1 1 1 1 1 1 1 1 1 1 1 1 1 1 26 1 1 1 1 1 1 1 1 1 1 1 1 1 1 1 1 1 1 1 1 1 1 1 1 1 
1 1 1 1 1 1 1 1 1 1 1 1 1 1 1 1 1 1 1 1 1 1 1 1 2 1 1 1 1 1 1 1 1 1 1 1 1 1 1 1 1 1 4 1 1 1 1 1 1 1 
1 4 1 1 1 1 1 1 23 11 23 26 1 1 1 1 1 1 1 1 23 23 23 23 23 23 23 23 23 23 23 5 23 23 23 23 23 1 1 1 1 1 1 1 1 1 1 1 1 1 
1 1 1 1 1 1 1 1 23 23 23 2 1 1 1 1 1 23 23 23 23 23 23 5 23 23 23 23 23 23 23 23 23 23 23 27 23 23 1 1 1 1 1 1 1 1 1 4 1 1 
1 1 1 1 1 1 1 23 23 23 23 23 23 23 23 23 23 23 23 23 23 23 23 23 23 23 23 23 23 23 23 23 23 23 23 3 23 23 23 1 1 1 1 1 1 1 1 1 1 1 
1 1 1 1 1 1 1 23 23 23 23 23 23 23 23 23 23 1 1 23 23 23 23 23 23 23 5 23 13 14 21 22 23 23 23 23 23 23 23 1 1 1 1 1 1 1 1 1 1 1 
1 1 1 1 1 1 26 1 1 23 23 1 1 1 1 26 1 1 1 23 23 23 23 23 23 23 23 23 16 17 18 19 23 23 23 23 23 23 5 1 1 1 1 1 1 1 1 1 1 1 
4 1 1 1 1 1 2 1 1 1 1 1 1 1 1 2 1 1 1 23 23 23 23 23 23 23 23 23 28 8 9 30 0 23 23 23 23 23 23 1 1 1 1 4 1 1 1 1 1 1 
1 1 1 1 1 1 1 1 1 1 1 1 1 1 1 1 1 1 1 1 23 5 23 23 23 23 23 23 23 23 23 23 23 23 23 23 23 23 23 1 1 1 1 1 1 1 1 1 1 1 
1 1 1 1 1 1 1 1 1 1 1 1 1 1 1 1 1 1 1 1 23 23 23 23 23 23 23 23 23 23 23 23 23 23 23 23 23 23 23 1 1 1 1 1 1 1 4 4 4 4 
1 1 1 4 1 1 1 1 1 1 1 1 1 1 1 1 1 1 26 1 1 1 23 23 23 23 23 23 23 23 23 23 23 23 23 23 23 5 1 1 1 1 1 1 1 4 4 4 4 4 
1 1 1 1 1 1 1 1 1 1 1 1 1 1 1 1 1 1 2 1 1 1 23 23 23 23 5 23 23 23 23 23 23 23 23 23 23 23 1 1 1 1 4 4 4 4 4 4 4 4 
1 1 1 1 1 1 1 1 1 1 1 1 1 1 1 1 1 1 1 1 1 1 1 23 23 23 23 23 23 23 23 23 23 23 23 23 23 23 1 1 4 4 4 4 4 4 4 4 4 4 
1 4 1 1 1 1 1 4 1 1 1 1 1 1 1 1 1 1 1 1 1 1 1 1 1 1 1 1 1 1 1 4 25 4 4 4 4 4 4 4 4 4 4 4 4 4 4 4 4 4 
1 1 4 1 1 1 1 1 1 1 1 1 1 4 1 1 1 1 1 1 1 1 1 1 1 1 1 1 1 4 4 4 25 4 4 4 4 4 4 4 4 4 4 4 4 4 4 4 4 4 
1 1 1 1 1 1 1 1 1 1 1 1 1 1 1 1 1 1 1 1 1 1 1 1 4 1 4 4 4 4 4 4 25 4 4 4 4 4 4 4 4 4 4 4 4 4 4 4 4 4 
1 1 1 1 23 23 23 23 23 23 1 1 1 1 1 1 1 1 4 1 1 1 1 1 4 4 4 4 4 4 4 4 25 4 4 4 4 4 4 4 4 4 4 4 4 4 4 4 4 4 
1 1 4 1 23 23 23 23 23 23 1 1 1 1 1 1 4 1 1 1 1 1 1 4 1 4 4 4 4 4 4 4 25 4 4 4 4 4 4 4 4 4 4 4 4 4 4 4 4 4 
1 1 1 23 23 23 23 23 23 23 1 1 1 1 1 1 1 1 1 1 1 1 1 1 1 4 1 4 4 4 4 4 25 4 4 4 4 4 4 4 4 4 4 4 4 4 4 4 4 4 
1 1 1 23 23 23 23 23 23 23 1 1 1 1 1 1 1 1 1 1 1 1 1 1 1 1 1 1 1 1 4 4 25 4 4 4 4 4 4 4 4 4 4 4 4 4 4 4 4 4 
1 1 1 23 23 23 23 23 23 1 1 4 1 1 1 1 1 1 1 1 1 1 1 1 1 1 1 1 1 1 1 23 23 1 4 4 4 4 4 4 4 4 4 4 4 4 4 4 4 4 
1 1 1 4 1 23 23 23 1 1 1 4 1 1 1 1 1 1 1 1 1 1 1 1 1 1 1 1 26 23 23 23 23 23 4 4 4 4 4 4 4 4 4 4 4 4 4 4 4 4 
1 1 1 1 1 25 1 1 1 1 1 1 1 1 1 1 1 1 1 1 23 1 1 1 1 23 23 23 2 23 23 23 23 23 23 23 4 4 4 4 4 4 4 4 4 4 4 4 4 4 
1 1 1 1 1 25 1 1 1 1 4 1 1 1 1 1 1 1 26 23 23 14 15 20 21 23 23 23 23 23 23 23 23 23 23 23 23 4 4 4 4 4 4 4 4 4 4 4 4 4 
1 1 1 1 1 25 1 1 1 1 1 1 1 1 1 1 1 1 2 23 23 15 15 20 20 23 23 23 23 23 23 23 23 23 23 23 23 23 23 23 4 4 4 4 4 4 4 4 4 4 
1 1 1 1 1 25 1 1 1 1 1 1 1 1 1 1 23 23 23 23 23 16 17 18 19 23 23 23 23 23 23 23 23 23 23 23 23 23 26 23 23 23 1 1 4 4 4 4 4 4 
1 1 1 1 1 25 1 1 1 1 1 1 1 1 23 23 23 23 23 23 23 28 9 29 30 23 23 23 23 23 23 23 23 23 23 23 23 23 2 23 23 23 1 1 1 4 4 4 4 4 
1 1 1 1 1 25 1 1 1 1 1 1 1 1 23 23 23 23 23 23 23 23 23 23 23 23 23 23 23 23 23 23 23 23 23 23 23 23 23 23 23 23 1 1 1 1 4 4 4 4 
1 1 1 1 1 25 1 4 1 1 1 1 1 1 23 23 23 23 23 23 23 23 23 23 23 23 23 23 23 23 23 23 23 23 23 23 23 13 14 21 22 23 1 5 1 1 1 1 1 1 
1 1 1 1 1 25 1 1 1 1 1 1 1 23 23 23 23 23 23 23 23 23 23 23 23 23 23 23 23 23 23 23 23 23 23 23 23 16 17 18 19 23 1 1 1 1 1 1 1 1 
1 1 1 4 1 25 1 1 1 1 1 1 23 23 23 23 23 23 23 23 23 23 23 23 23 23 23 23 23 23 23 23 23 23 23 23 23 29 29 29 29 23 1 1 1 1 1 1 1 1 
1 1 1 1 1 23 24 24 24 24 24 24 23 23 23 23 23 23 23 23 23 23 23 23 23 23 23 23 23 23 23 23 23 23 23 23 23 29 29 29 29 23 1 1 1 1 4 1 1 1 
1 1 1 1 1 1 1 1 1 1 1 1 1 1 1 1 23 23 23 23 23 23 23 23 23 23 23 23 23 23 23 23 23 23 23 23 23 29 8 9 29 23 1 1 1 1 4 1 1 1 
1 1 1 1 1 1 1 1 1 1 1 1 1 1 1 1 23 23 23 23 23 23 23 23 23 23 23 23 23 23 23 23 23 23 23 23 23 23 23 23 23 1 1 1 1 1 1 1 26 1 
1 1 1 1 1 1 1 4 1 1 1 1 1 1 1 1 1 23 23 23 23 23 23 23 23 23 23 23 23 23 23 23 23 23 23 23 23 23 23 23 23 1 1 1 1 1 1 1 2 1 
1 1 1 1 1 1 1 1 1 1 1 1 1 1 1 1 1 1 23 23 23 23 23 23 23 23 23 23 23 23 23 23 23 23 23 26 23 23 23 1 1 1 1 1 1 1 5 1 1 1 
1 1 1 1 1 1 1 1 1 1 1 4 1 1 1 1 1 1 1 23 23 26 23 23 23 23 23 23 23 23 23 23 23 23 23 2 23 23 1 1 1 1 1 1 1 1 1 1 1 1 
1 1 1 1 1 1 1 1 1 1 1 1 1 1 1 1 26 1 1 1 23 2 23 23 23 23 23 23 23 23 23 23 23 23 23 6 1 1 1 1 1 1 1 1 1 1 1 1 1 1 
1 1 1 1 1 1 1 1 1 1 1 1 1 1 1 1 2 1 1 1 1 1 23 23 23 23 23 23 23 23 23 23 23 23 1 1 1 1 1 1 1 26 1 1 1 1 1 1 1 1 
1 1 4 1 1 1 1 1 1 1 1 1 1 1 1 1 1 1 1 1 1 1 1 23 23 23 23 23 23 23 1 1 1 1 1 1 1 1 1 1 1 2 1 1 1 4 1 1 1 1 
1 1 1 1 1 1 1 1 1 1 1 1 1 1 1 1 1 1 1 1 1 1 1 1 1 1 1 1 1 1 1 1 1 1 1 1 1 1 1 1 1 1 1 1 1 1 1 1 1 1 
1 1 1 1 1 1 1 1 1 1 1 1 1 1 1 1 1 1 1 1 1 1 1 1 1 1 1 1 1 1 1 1 1 1 1 5 1 1 1 4 1 1 1 1 1 1 1 1 1 1 
1 1 1 1 1 1 1 1 1 1 1 1 1 1 1 1 1 1 1 1 1 1 1 1 1 1 1 1 1 4 1 1 1 1 1 1 1 1 1 1 1 1 1 1 1 1 1 1 1 1 
1 1 1 1 1 1 1 1 4 1 1 1 1 1 1 1 1 1 1 1 1 1 4 1 1 1 1 1 1 1 1 1 1 1 1 1 1 1 1 1 1 1 1 1 1 1 1 1 1 1 
1 1 1 1 1 1 1 1 1 1 1 1 1 1 1 1 1 1 1 1 1 1 1 1 1 1 1 1 1 1 1 1 1 1 1 1 1 1 1 1 1 1 4 1 1 1 1 1 1 4 
1 1 1 1 1 1 1 1 1 1 1 1 1 1 1 1 1 1 1 1 1 1 1 1 1 1 1 1 1 1 1 1 1 1 1 1 1 1 1 1 1 1 1 1 1 1 1 1 1 1 
