5 5 5 5 5 5 5 5 5 5 5 5 5 5 5 5
5 5 5 2 2 2 2 2 2 2 2 2 2 5 5 5
5 5 2 2 2 1 1 1 1 1 1 1 1 2 5 5
5 2 2 2 1 1 1 1 1 1 1 1 3 2 2 5
5 2 2 1 3 1 1 0 0 0 1 1 1 1 2 5
5 2 1 1 1 1 1 0 5 0 1 1 1 1 2 5
5 5 2 1 1 1 1 0 0 0 1 1 1 1 2 5
5 2 2 1 1 3 1 4 4 4 1 1 1 1 2 5
5 2 2 2 1 1 1 4 1 1 1 1 1 1 2 5
5 2 5 2 1 1 1 4 4 4 1 1 1 1 2 5
5 2 5 2 2 2 2 2 2 2 2 2 2 2 5 5
5 5 5 5 5 5 5 5 5 5 5 5 5 5 5 5