1 1 1 1 1 1 1 1 1 1 1 1 1 1 1 1 1 1 1 1 1 1 1 1 1 1 1 1 1 1 1 1 1 1 1 1 1 1 1 1 1 1 4 1 1 1 1 1 1 1 
1 1 1 1 1 1 1 1 4 1 1 1 1 1 1 1 1 1 1 1 1 1 1 4 1 1 1 1 1 1 4 1 1 1 1 1 1 1 1 1 1 1 1 1 1 1 1 1 1 1 
1 4 1 1 1 1 1 1 1 1 1 1 1 1 1 1 1 1 1 1 1 1 1 1 1 1 1 1 1 1 1 1 1 1 1 1 1 1 1 1 1 1 1 1 1 1 1 1 1 1 
1 1 1 1 1 1 1 1 1 1 1 1 1 1 1 4 1 1 1 1 1 1 1 1 1 1 1 1 1 1 1 1 1 1 1 1 1 1 1 4 1 1 1 1 1 1 1 4 1 1 
4 1 1 1 1 1 1 1 1 1 1 1 1 1 1 1 1 1 1 1 1 1 1 1 1 1 1 1 1 1 1 1 1 1 1 1 1 1 1 1 1 1 1 1 1 1 1 1 1 1 
1 1 1 1 1 1 1 1 1 1 1 1 1 1 1 1 1 1 1 1 1 1 1 1 1 1 1 1 1 1 1 1 1 1 1 1 1 1 1 1 1 1 4 1 1 1 1 1 1 1 
1 4 1 1 1 1 1 1 v v v v 1 1 1 1 1 1 1 1 v v v v v v v v v v v 23 v v v v v 1 1 1 1 1 1 1 1 1 1 1 1 1 
1 1 1 1 1 1 1 1 v v v 23 1 1 1 1 1 v v v v v v 23 v v v v v v v v v v v v v v 1 1 1 1 1 1 1 1 1 4 1 1 
1 1 1 1 1 1 1 v v v v v v v v v v v v v v v v v v v v v v v v v v v v 23 v v v 1 1 1 1 1 1 1 1 1 1 1 
1 1 1 1 1 1 1 v v v v v v v v v v 1 1 v v v v v v v 23 v v v v v v v v v v v v 1 1 1 1 1 1 1 1 1 1 1 
1 1 1 1 1 1 1 1 1 v v 1 1 1 1 1 1 1 1 v v v v v v v v v 16 17 18 19 v v v v v v 23 1 1 1 1 1 1 1 1 1 1 1 
4 1 1 1 1 1 1 1 1 1 1 1 1 1 1 1 1 1 1 v v v v v v v v v 28 8 v 30 23 v v v v v v 1 1 1 1 4 1 1 1 1 1 1 
1 1 1 1 1 1 1 1 1 1 1 1 1 1 1 1 1 1 1 1 v 23 v v v v v v v v v v v v v v v v v 1 1 1 1 1 1 1 1 1 1 1 
1 1 1 1 1 1 1 1 1 1 1 1 1 1 1 1 1 1 1 1 v v v v v v v v v v v v v v v v v v v 1 1 1 1 1 1 1 4 4 4 4 
1 1 1 4 1 1 1 1 1 1 1 1 1 1 1 1 1 1 1 1 1 1 v v v v v v v v v v v v v v v 23 1 1 1 1 1 1 1 4 4 4 4 4 
1 1 1 1 1 1 1 1 1 1 1 1 1 1 1 1 1 1 1 1 1 1 v v v v 23 v v v v v v v v v v v 1 1 1 1 4 4 4 4 4 4 4 4 
1 1 1 1 1 1 1 1 1 1 1 1 1 1 1 1 1 1 1 1 1 1 1 v v v v v v v v v v v v v v v 1 1 4 4 4 4 4 4 4 4 4 4 
1 4 1 1 1 1 1 4 1 1 1 1 1 1 1 1 1 1 1 1 1 1 1 1 1 1 1 1 1 1 1 4 v 4 4 4 4 4 4 4 4 4 4 4 4 4 4 4 4 4 
1 1 4 1 1 1 1 1 1 1 1 1 1 4 1 1 1 1 1 1 1 1 1 1 1 1 1 1 1 4 4 4 v 4 4 4 4 4 4 4 4 4 4 4 4 4 4 4 4 4 
1 1 1 1 1 1 1 1 1 1 1 1 1 1 1 1 1 1 1 1 1 1 1 1 4 1 4 4 4 4 4 4 v 4 4 4 4 4 4 4 4 4 4 4 4 4 4 4 4 4 
1 1 1 1 23 23 23 23 23 23 1 1 1 1 1 1 1 1 4 1 1 1 1 1 4 4 4 4 4 4 4 4 v 4 4 4 4 4 4 4 4 4 4 4 4 4 4 4 4 4 
1 1 4 1 23 23 23 23 23 23 1 1 1 1 1 1 4 1 1 1 1 1 1 4 1 4 4 4 4 4 4 4 v 4 4 4 4 4 4 4 4 4 4 4 4 4 4 4 4 4 
1 1 1 23 23 23 23 23 23 23 1 1 1 1 1 1 1 1 1 1 1 1 1 1 1 4 1 4 4 4 4 4 v 4 4 4 4 4 4 4 4 4 4 4 4 4 4 4 4 4 
1 1 1 23 23 23 23 23 23 23 1 1 1 1 1 1 1 1 1 1 1 1 1 1 1 1 1 1 1 1 4 4 v 4 4 4 4 4 4 4 4 4 4 4 4 4 4 4 4 4 
1 1 1 23 23 23 23 23 23 1 1 4 1 1 1 1 1 1 1 1 1 1 1 1 1 1 1 1 1 1 1 v v 1 4 4 4 4 4 4 4 4 4 4 4 4 4 4 4 4 
1 1 1 4 1 23 23 23 1 1 1 4 1 1 1 1 1 1 1 1 1 1 1 1 1 1 1 1 v v v v v v 4 4 4 4 4 4 4 4 4 4 4 4 4 4 4 4 
1 1 1 1 1 25 1 1 1 1 1 1 1 1 1 1 1 1 1 1 v 1 1 1 1 v v v 23 v v v v v v v 4 4 4 4 4 4 4 4 4 4 4 4 4 4 
1 1 1 1 1 25 1 1 1 1 4 1 1 1 1 1 1 1 v v v v v v v v v v v v v v v v v v v 4 4 4 4 4 4 4 4 4 4 4 4 4 
1 1 1 1 1 25 1 1 1 1 1 1 1 1 1 1 1 1 23 v v 15 15 20 20 v v v v v v v v v v v v v v v 4 4 4 4 4 4 4 4 4 4 
1 1 1 1 1 25 1 1 1 1 1 1 1 1 1 1 v v v v v 16 17 18 19 v v v v v v v v v v v v v v v v v 1 1 4 4 4 4 4 4 
1 1 1 1 1 25 1 1 1 1 1 1 1 1 v v v v v v v 28 v 29 30 v v v v v v v v v v v v v 23 v v v 1 1 1 4 4 4 4 4 
1 1 1 1 1 25 1 1 1 1 1 1 1 1 v v v v v v v v v v v v v v v v v v v v v v v v v v v v 1 1 1 1 4 4 4 4 
1 1 1 1 1 25 1 4 1 1 1 1 1 1 v v v v v v v v v v v v v v v v v v v v v v v v v v v v 1 1 1 1 1 1 1 1 
1 1 1 1 1 25 1 1 1 1 1 1 1 v v v v v v v v v v v v v v v v v v v v v v v v 16 17 18 19 v 1 1 1 1 1 1 1 1 
1 1 1 4 1 25 1 1 1 1 1 1 v v v v v v v v v v v v v v v v v v v v v v v v v 28 29 29 30 v 1 1 1 1 1 1 1 1 
1 1 1 1 1 23 24 24 24 24 24 24 v v v v v v v v v v v v v v v v v v v v v v v v v 28 29 29 30 v 1 1 1 1 4 1 1 1 
1 1 1 1 1 1 1 1 1 1 1 1 1 1 1 1 v v v v v v v v v v v v v v v v v v v v v 28 8 v 30 v 1 1 1 1 4 1 1 1 
1 1 1 1 1 1 1 1 1 1 1 1 1 1 1 1 v v v v v v v v v v v v v v v v v v v v v v v v v 1 1 1 1 1 1 1 1 1 
1 1 1 1 1 1 1 4 1 1 1 1 1 1 1 1 1 v v v v v v v v v v v v v v v v v v v v v v v v 1 1 1 1 1 1 1 4 1 
1 1 1 1 1 1 1 1 1 1 1 1 1 1 1 1 1 1 v v v v v v v v v v v v v v v v v v v v v 1 1 1 1 1 1 1 4 1 1 1 
1 1 1 1 1 1 1 1 1 1 1 4 1 1 1 1 1 1 1 v v v v v v v v v v v v v v v v 23 v v 1 1 1 1 1 1 1 1 1 1 1 1 
1 1 1 1 1 1 1 1 1 1 1 1 1 1 1 1 1 1 1 1 v 23 v v v v v v v v v v v v v 23 1 1 1 1 1 1 1 1 1 1 1 1 1 1 
1 1 1 1 1 1 1 1 1 1 1 1 1 1 1 1 1 1 1 1 1 1 v v v v v v v v v v v v 1 1 1 1 1 1 1 1 1 1 1 1 1 1 1 1 
1 1 4 1 1 1 1 1 1 1 1 1 1 1 1 1 1 1 1 1 1 1 1 v v v v v v v 1 1 1 1 1 1 1 1 1 1 1 1 1 1 1 4 1 1 1 1 
1 1 1 1 1 1 1 1 1 1 1 1 1 1 1 1 1 1 1 1 1 1 1 1 1 1 1 1 1 1 1 1 1 1 1 1 1 1 1 1 1 1 1 1 1 1 1 1 1 1 
1 1 1 1 1 1 1 1 1 1 1 1 1 1 1 1 1 1 1 1 1 1 1 1 1 1 1 1 1 1 1 1 1 1 1 1 1 1 1 4 1 1 1 1 1 1 1 1 1 1 
1 1 1 1 1 1 1 1 1 1 1 1 1 1 1 1 1 1 1 1 1 1 1 1 1 1 1 1 1 4 1 1 1 1 1 1 1 1 1 1 1 1 1 1 1 1 1 1 1 1 
1 1 1 1 1 1 1 1 4 1 1 1 1 1 1 1 1 1 1 1 1 1 4 1 1 1 1 1 1 1 1 1 1 1 1 1 1 1 1 1 1 1 1 1 1 1 1 1 1 1 
1 1 1 1 1 1 1 1 1 1 1 1 1 1 1 1 1 1 1 1 1 1 1 1 1 1 1 1 1 1 1 1 1 1 1 1 1 1 1 1 1 1 4 1 1 1 1 1 1 4 
1 1 1 1 1 1 1 1 1 1 1 1 1 1 1 1 1 1 1 1 1 1 1 1 1 1 1 1 1 1 1 1 1 1 1 1 1 1 1 1 1 1 1 1 1 1 1 1 1 1 
